NO ./images/oldNO.xpm
SO ./images/oldSO.xpm
WE ./images/oldWE.xpm

F 0,0,30
C 20,200,0
EA ./images/oldEA.xpm

		11111111111111			11111111111111111111111
		10000000000001			10000001000000000000001
		10000000000001111111111111110000000000000000001
		10000000000000000010000000000000000000000000001
		10000000000000000010000000000000000000000000001
		10000000000000000010000000000000000000000000001
		10000000000000000010000000000000000000000000001
		10000000000000000010000000000000000000000000001
		11111111001111111110000000000000000000000000001
		10000000000000000010000000000000000000000000001
1111111110000000000000000010000000000000000000000000001
1000000010000000000000000010000000000000000000000000001
1000N00010000000000000000010000000000000000000000000001
1000000010000000000000000010000000000000000000000000001
1000000010000000000000000000000000000000000000000000001
1000000000000000000000000000000000000000000000000000001
1111111111111111111111111111111111111111111111111111111
