NO ./images/NO.xpm
SO ./images/SO.xpm
WE ./images/WE.xpm

F 2,100,0
C 225,30,0
EA ./images/EA.xpm

	111111111111111111111111
	1000000000110000000000001
	1011000001111000000000001			111111111
	100100000001 10000000000011111		110000011
1111111110110000101110000000000001		100000001
100000000011000001110111111111111		111111111
11110111111111011100000010001
11110111111111011101010010001
1100000011110011100000010001
1000000100110000001100000011
10000000111100001101010010001
1100000111010101111101111000111
1111S11 1110101 101111010001
11111111 1111111 111111111111
