NO ./images/oldNO.xpm
SO ./images/oldSO.xpm
WE ./images/oldWE.xpm
EA ./images/oldEA.xpm

F 2,10,0
C 225,30,0

1111111111111111111111111111111111111111111111111111
1000000000000000000000000000000000000000000000000001
10000000N0000000000000000000000000000000000000000001
1000000000000000000000000000000000000000000000000001
1111111111111111111111111111111111111111111111111111
